16 16
1 1 1 1 1 1 1 1 1 1 1 1 1 1 1 1 
1 4 2 2 2 1 2 2 2 1 1 2 2 2 1 1 
1 2 1 1 2 1 1 1 2 2 2 2 1 2 2 1 
1 2 2 1 2 2 2 2 1 2 1 1 2 2 1 1 
1 2 1 2 1 1 2 1 2 2 1 2 1 2 2 1 
1 2 1 2 2 1 2 1 2 1 1 2 2 1 2 1 
1 2 2 1 2 2 2 1 2 2 2 1 2 2 2 1 
1 1 2 2 1 2 1 2 2 1 2 2 1 2 1 1 
1 1 1 2 2 2 1 1 1 2 2 1 2 2 2 1 
1 1 2 2 1 1 2 2 2 2 1 2 1 1 2 1 
1 2 2 1 2 2 2 1 2 1 2 2 2 2 1 1 
1 2 1 2 2 1 1 2 1 1 2 1 1 2 2 1 
1 2 2 1 2 2 2 2 2 2 2 2 1 2 1 1 
1 1 2 2 1 1 1 1 1 1 1 1 2 2 2 1 
1 1 1 2 2 2 2 2 2 2 2 2 2 1 8 1 
1 1 1 1 1 1 1 1 1 1 1 1 1 1 1 1 
